PTTPTTTP
RRTTTTTT
PRTTTRRR
TTTTTTTP
PRRTTTRR
TRRPRPRR
TRRRRRRR
TTTTTTTB